-------------------
-------------------
-------------------
---W------------F--
   W---------------
---W---------------
---W---------------
--SW---------------
---W---------------
---W---------------