/d
fourth one
bighandinsky
tester
2019-11-13
/m
-------------------
-------------------
-------------------
---W------------F--
   W---------------
---W---------------
--- ---------------
--S ---------------
--- ---------------
--- ---------------